011111111111111111111
1000C0000000000000001
100000000000000001111
100000000000000000011
10P0000000C000000E011
1000000M0000000000011
100000000000000001111
1000C0000000000000001
111111111111111111111
