111111111111111111111
100000000000000000001
1000P0000000000001111
100000000000000000011
10000000C000000000011
100000C00E00000000011
100000000000000001111
10000000C0000M0001C01
111111111111111111111
