111111111111111111111
100000000000000010E01
100000000000000001111
100000000000000000011
1000M000C000000000011
100000C0000P000000011
100000000000000001111
10000000C000000000001
111111111111111111111
