111111111111111111111
100000000000000000001
100000000000000001111
100000000000000000011
10000000000000000E011
100000C00000000000011
100000M00000000001111
100000000000000001P01
111111111111111111111
