111111111111111111111
1000C0000000000000001
100000000000000001111
100000000000000000011
1000000000C0000000011
100000000000000000011
1000000000000P0001111
1000C0000000000000E01
111111111111111111111