111111111111111111111
1000C0000000000000001
10000000000M000001111
1000M0000000000000011
1000000000C000000E011
100000 M00000000M0011
1000000000000P0001111
1000C0000000000000001
111111111111111111111