1111111111111111111
10000P1000001000001
1011111C00001000001
1000C00000C0100C001
1111110000001111101
1C0000C00000C010001
1000C010C0M00000001
1111001000C00001111
1000001000000000E11
1111111111111111111
